10 20
####################
#___#_#_#_#___#_##_#
###_#_____###______#
##__##_##___#_###_##
#_I##___###_###____#
#_#####_#___#___##_#
#_#_____##_###_##__#
#_##_####___#__#__##
#___F#____#___##_###
####################